111111111111111111111111111111111111111111111111111111111111111111111111111111111111111111111111111111111111111111111111111111111111111111
111000000000000000001111111111111111110000000000000000000000001110000000011111100000111110000000000000000000000000000000000000111111111111
110000000000000000000111111111111110000000000000000000000000000100000000000000000000000000000000000000000000000000000000000000001111111111
100000000000000000000000111110000000000000000000000000000000000100000000000000000000000000000000000000000000000111000000000000000111111111
111000000000000000000000000000000000000000000000000000000000000000000000000111100000000011111000000000000000111111111111000010001111111111
111111111111111110000000000000000111111111111111111111111111110001111111111000011111111111111111111111111111111111111111111110000111111111
111110000000000011110000000000111111111000000001111000000000011111000000000000000000000011000000000000000000001111000001111111100011111111
111100000000000000001100001111100000000000000000000000000000000110000000000110000000000110000001111111000000000000000000000000000001111111
111000000000000000000111111000000000000000000000000000000000000000000000011100000000001111111110000000000000000000000000000000000011111111
111110000000000000000000000000000000000000000000000000000000000000000001111000000000000000000000000000000001110000000000000000001111111111
111111100001111111100000000000000110001111111111111111111111111111111111111111111111111111111111111111111111111111111111111111111111111111
111111110000011111111110000111111111111111100000000111111111111111111111111111111111111111111111111111111110000000000000000000000001111111
111111111000000000000001111000000011111110000000000000011111111111111111111111111111111111111111111111111000000000000000000000000000001111
111111111111100000000000000000000000111000000000000000001111111111111111110000001111111111111111111111000000000000000000000000000000011111
111111111111111110000000001111000000000000000111111100000000000000000000000000000000000000000000000000000000000000000000000000001111111111
111111111111111111111111111111111111111111111111111110000000000000000000000111000000000000000000000000001111110000000000000001111111111111
111111111111110000000000000000000000000000001111111111111111111111111111111111111111110011111111111111111100000000000000001111111111111111
111111111110000000000000000000011111000000000001111100000000000000111111100000000011111111111111000000000000000000000000000011111111111111
111111111000000000000000000000000011110000000001111000000000000000000000000000000111000000000000000000000000000000000000000111111111111111
111111100000000000000000000000000001100000000000000000000000000000000000000000111111110000000000000000000000000000000000000000001111111111
111111110000000000000000000000000000000000000000000000000000000000000000000011111111111000000000000000000000000000000000000000011111111111
111111111100000011111111111111111111111111111111111111110000000000000011111111111111111111000000000000000000000111111111111111111111111111
111111111100000111111111111111111111111111111111111111111111000000011111111111111111111111100000000000001111111111111111111111111111111111
111111110000000000111111111111111111111111111111111111111111110000000000000011111111111111111000000000111111111111111111111111111111111111
111111111000000001111111111111111111111111111111111111111111111100000000000000111111111110000000000111111111111111111111111111111111111111
111111110000400000111111111111111111111111111111111111111111111111111111111000000011100000000000111111111111111111111111111111111111111111
111111111000000001111111111111111111111111111111111111111111111111111111111110000000000000111111111111111111111111111111111111111111111111
111111111111111111111111111111111111111111111111111111111111111111111111111111111111111111111111111111111111111111111111111111111111111111