111111111111111111111111111111111111111111111111111111111111111111111111111111111111111111111111111111111111111111111111111111111111111111
111000000000000000001111111111111111110000000000000000000000001110000000011111100000111110000000000000000000000000000000000000111111111111
110000000000000000000111111111111110000000000000000000000000000200000000000000000000000000000000000000000000000000000000000000001111111111
100000000000000000000000111110000000000000000000000000000000000000000000000000000000000000000000000000000000000111000300000000000111111111
111000000000000000000000020000000000000000000000000000000000000000000000001111100000000011111000000000000000111111111111000010001111111111
111111111111111110000000000000000111111111111111111111111111110001111111110000011111111111111111111111111111111111111111111110000111111111
111110000000000011110000000000111111111000000001111000000000011111000000000000000000000011000000000000000000001111000001111111100011111111
111100000000000000001133001111100000000000000000000000000000000200000000000300000000000110000001111111000000000000000000000000000001111111
111000000000000000000111111000000000000000000000000000000000000000000000011100000000001111111110000000000000000000000000000000000011111111
111110000000000000000000000000000000000000000000300000000000000000000001111000000000000000000000000000000001110000000000000000001111111111
111111100001111111100000000000000110001111111111111111111111111111111111111111111111111111111111111111111111111111111111111111111111111111
111111110000011111111110000111111111111111100000000111111111111111111111111111111111111111111111111111111110000000001111110000200001111111
111111111000000000000001111000000011111110000000000000011111111111111111111111111111111111111111111111111000000000000020200000000000001111
111111111111100000000000000000000000111000000000000000001111111111111111110000001111111111111111111111000000000000000000000000000000011111
111111111111111110000000001111000000000000000111111100000000000000000000000000000000000000000000000000000000000000000000000000301111111111
111111111111111111111111111111111111111111111111111110000000000000000000000111000000000000000000000000001111110000000000000001111111111111
111111111111110000200020000000000000000000001111111111111111111111111111111111111111110011111111111111111100200000000000001111111111111111
111111111110000000000000000000011111000000000001111100020000020000111111100002000011111111111111000000000000000000000000000011111111111111
111111111000000000000000000000000011110000000001111000000000000000000002000000000111000000020000000000000000000000000000000111111111111111
111111100000000000000000000000000001100000000000000000000000000000000000000000111111110000000000000000000000000000000000000020001111111111
111111110300000000000300003000000000000000300000000000000000000000000000000011111111111000000000000000000000000000000300300000011111111111
111111111100000011111111111111111111111111111111111111110000000000000011111111111111111111000000000000000003000111111111111111111111111111
111111111100000111111111111111111111111111111111111111111111030000011111111111111111111111103000000000001111111111111111111111111111111111
111111110000000000111111111111111111111111111111111111111111110000000000000011111111111111111000000000111111111111111111111111111111111111
111111111000400001111111111111111111111111111111111111111111111100000000000000111111111110000000000111111111111111111111111111111111111111
111111110000000000111111111111111111111111111111111111111111111111111111111000000011100000000000111111111111111111111111111111111111111111
111111111030303001111111111111111111111111111111111111111111111111111111111110000000000000111111111111111111111111111111111111111111111111
111111111111111111111111111111111111111111111111111111111111111111111111111111111111111111111111111111111111111111111111111111111111111111