000000000000000000000000000000000000000000000000000000000000000000000000000000000000000000000000000000000000000000000000000000000000000000
000000000000000000000000000000000000000000000000000000000000000000000000000000000000000000000000000000000000000000000000000000000000000000
111111111111111111111111111111111111111111111111111111111111111111111111111111111111111111111111111111111111111111111111111111111111111111
000000000000000000000000000000000000000000000000000000000000000000000000000000000000000000000111111000000000000001111000000000000000000001
000000000000000000000000000000000000000000000000000000000000000000000000000000000000000000000000000000000000000001111000000000000000000001
000000000000000000000001010010001000010000000000000000000000000000000000000000000000000000000000000000000000000001111000000000000000000001
000000000000000000000000000000000000000000000000000000000000000000000000000000000000000001000000000000111000000000011000000000000000000001
000000000000000000000000000000000000000000000000000000000000000000000000000000000000000001000000000000111000000000000000000000000000000001
000000000000000000000000000000000000000000000000000000000000000000000000000000000000000001000000000000111100000000000000000000000000000001
000000000000000000000000000000000000000000000000000000000000000000000000000000000000000001000000000000111100000000000000000000000000000001
111111111111111000000011111111111111111111111111111111111111111111111111111111111111111111111111111111111111111111111111111111110000000001
000000000000000000000000000000000000000000000000000000000000000000000000000000000000000000000000000000000000000000000000000000000000000001
000000000000000000000000000000000000000000000000000000000000000000000000000000000000000000000000000000000000000000000000000000000000000001
000000000000000000000000000000000000000000000000000000000000000000000000000000000000000000000000000000000000000000000000000000000000000001
000000000000000000000000000000000000000000000000000000000000000000000000000000000000000000000000000000000000000000000000000000000000000001
000000000000000000000000000000111111111111111111111111100000000000011111111111111110011111111111111110111111111111111111111111111111111111
000000000000000000000000000000000000000000000000000000000000000000000000000000000000000000000000000000000000000000000000000000000000000001
000000000000000000000000000000000000000000000000000000000000000000000000000000000000000000000000000000000000000000000000000000000000000001
000000000000000000000000000000000000000000000000000000000000000000000000000000000000000000000000000000000000000000000000000000000000000001
111111111111111111111111111111110000000001111111111111111111111111111111111111111111111111111111111111111111111111111111111111111111111111
000000000000000000000000000000000000000000000000000000000000000000000000000000000000000000000000000000000000000000000000000000000000000000
000111110011100111001111100000000000011110000000000000000000000000000000000000000000000000000000000000000000000000000000000000000000000000
000001000010000100000010000000000000000000000000000000000000000000000000000000000000000000000000000000000000000000000000000000000000000000
000001000011100111000010000000000000000000000000000000000000000000000000000000000000000000000000000000000000000000000000000000000000000000
000001000010000001000010000000000000000000000000000000000000000000000000000000000000000000000000000000000000000000000000000000000000000000
000001000011100111000010000000000000000000000000000000000000000000000000000000000000000000000000000000000000000000000000000000000000000000
000000000000000000000000000000000000000000000000000000000000000000000000000000000000000000000000000000000000000000000000000000000000000000
000000000000000000000000000000000000000000000000000000000000000000000000000000000000000000000000000000000000000000000000000000000000000000