111111111111111111111111111111111111111111111111111111111111111111111111111111111
100000000001111111111111111111111111111111111111110000000000000000000000011111111
100000000000011111111111111111111111110000000000000000000000000000000000000001111
111000000001111111111111110000000000000000000000000000000111111111111100000001111
11111100000011110000000000000000000000000000011111111111111111111111110000001111
111111110000010000000000000000011111111100000011111111111111111111111111000001111
111111111110000001111111111111111111111111000000000000000000000011111100000011111
111111111111000011111111111111111111111111111110000000000000000000000000011111111
111111111111111111000000000000011111111111111111111111111111111100000011111111111
111111000000000000000000000000000000000000011111111111111111111110000000011111111
111000000000000000000011111110000000000000000000000000011111111111111000000111111
111000000000011111111111111111111000000000000000000000000000000000000000000001111
111030000003011111111111111111111111111111100000000000000000000000000000000300111
111110000011111111111111111111111111111111111111111111111111111111111111111111111
111110000000111111111111111100000000011111111111111111111111020202020202020211111
111111100000001111111111100000000000000000000000000000000000000000000000000011111
111111111100000011111100000000000000000000000000000000000000000000000040000011111
111111111111000000000000000000000000000000000000000000000000000000000000000011111
111111111111110000000000011111111111111111111111111111111111030303030303030311111
111111111111111111111111111111111111111111111111111111111111111111111111111111111