111111111111111111111111111111111111111111111111111111111111111111111111111111111
110000000000000000000000000000000000000000000000000000000000000000000111111111111
110000000000000000000000000000000000000000000000000000000000000000000001111111111
110000000000000000000000000000000000000000000000000000111111100000000001111111111
110000000000000001111100000000000000000000000000000111111111111000000001111111111
111111111111111111111111111111110000000111111111111111111111111111110000111111111
111111111000000000000000111111100000011111111111111110000000001111111100011111111
111111100000000000000000111100000000000111111110000000000000000000000000001111111
111111111111111111100000000000000000000000000000000000000000000000000000001111111
111111111111111111000000000000000000000000000000001110000000000000000000001111111
111111111111111111000000000000111111111111111111111111111111100000000000000011111
111111111111111111000111111111111111111111111111100000000011111100000000000111111
111111111111111000000001111111111111111111111111000000000000000000000000000011111
111111111111100000001111111111111111111111111000000000000000000000000000000011111
111111111100000001111111111111000000000000000000000000000000000000000001111111111
111100000000001111111111111100000000000000000001111110000000000000001111111111111
111000001111111111111111100000000111111111111111111100000000000000011111111111111
110000001111111111111100000000000001111111111111110000000000000000011111111111111
110000000000000000000000000000000000000111111110000000000000000000011111111111111
110000000000000000000001111110000000000000000000000000000000000000001111111111111
111110000000000000011111111111000000000000000000000000000000000000001111111111111
111111111111111111111111111111111000000000000000003000111111111111111111111111111
111111111111111111111111111111111103000000000001111111111111111111111111111111111
111110000000000000011111111111111111000000000111111111111111111111111111111111111
111111000040000000000111111111110000000000111111111111111111111111111111111111111
111111000000000000000000011100000000000111111111111111111111111111111111111111111
111111111111111111110000000000000111111111111111111111111111111111111111111111111
111111111111111111111111111111111111111111111111111111111111111111111111111111111